ag	be	cdf
abef	cd	g
abe	cdg	f
abcef	d	g
a	bcdfg	e
a	bdefg	c
a	bcefg	d
abe	cfg	d
adfg	be	c
abdef	c	g
abceg	d	f
a	bcdeg	f
a	befg	cd
ab	cdfg	e
a	bcdef	g
a	be	cdfg
acdeg	b	f
acdg	be	f
abcdf	e	g
abeg	cf	d
abdeg	c	f
abfg	cd	e
acdef	b	g
afg	be	cd
adefg	b	c
abg	cdf	e
aefg	b	cd
abefg	c	d
abcfg	d	e
acefg	b	d
abdfg	c	e
abe	cdf	g
abcde	f	g
abe	c	dfg
a	beg	cdf
abeg	c	df
aeg	b	cdf
ae	b	cdfg
abcdg	e	f
acfg	be	d
a	b	cdefg
abeg	cd	f
abe	cd	fg
acdfg	b	e
acdf	be	g